//MAP CONVERTED BY dmm2tgm.py THIS HEADER COMMENT PREVENTS RECONVERSION, DO NOT REMOVE
"a" = (
/turf/closed/indestructible/riveted,
/area/centcom/thanos_farm)
"b" = (
/turf/open/floor/grass,
/area/centcom/thanos_farm)
"c" = (
/obj/structure/bonfire/prelit,
/turf/open/floor/grass,
/area/centcom/thanos_farm)
"d" = (
/turf/closed/wall/mineral/wood,
/area/centcom/thanos_farm)
"e" = (
/obj/machinery/vending/hydroseeds,
/turf/open/floor/carpet/black,
/area/centcom/thanos_farm)
"f" = (
/obj/machinery/vending/hydronutrients,
/turf/open/floor/carpet/black,
/area/centcom/thanos_farm)
"g" = (
/turf/open/floor/carpet/black,
/area/centcom/thanos_farm)
"h" = (
/obj/structure/reagent_dispensers/watertank/high,
/turf/open/floor/carpet/black,
/area/centcom/thanos_farm)
"i" = (
/obj/structure/table/wood,
/obj/item/storage/box/beakers,
/turf/open/floor/carpet/black,
/area/centcom/thanos_farm)
"j" = (
/turf/open/water/jungle,
/area/centcom/thanos_farm)
"k" = (
/obj/structure/table/wood,
/turf/open/floor/carpet/black,
/area/centcom/thanos_farm)
"l" = (
/obj/structure/table/wood,
/obj/item/melee/roastingstick,
/obj/item/melee/roastingstick,
/turf/open/floor/carpet/black,
/area/centcom/thanos_farm)
"m" = (
/obj/structure/table/wood,
/obj/item/food/grown/watermelon,
/turf/open/floor/carpet/black,
/area/centcom/thanos_farm)
"n" = (
/obj/machinery/hydroponics/soil,
/turf/open/floor/grass,
/area/centcom/thanos_farm)
"o" = (
/obj/effect/landmark/start/thanos_portal,
/turf/open/floor/grass,
/area/centcom/thanos_farm)
"p" = (
/obj/machinery/hydroponics/soil,
/obj/effect/landmark/start/thanos_portal,
/turf/open/floor/grass,
/area/centcom/thanos_farm)
"q" = (
/obj/effect/landmark/start/thanos,
/turf/open/floor/carpet/black,
/area/centcom/thanos_farm)
"r" = (
/obj/machinery/computer/camera_advanced,
/turf/open/floor/carpet/black,
/area/centcom/thanos_farm)
"s" = (
/obj/machinery/telecomms/relay/preset/auto,
/turf/open/floor/carpet/black,
/area/centcom/thanos_farm)
"t" = (
/obj/machinery/seed_extractor,
/turf/open/floor/carpet/black,
/area/centcom/thanos_farm)
"u" = (
/obj/structure/flora/tree/jungle/small/style_6,
/turf/open/floor/grass,
/area/centcom/thanos_farm)
"x" = (
/obj/structure/flora/tree/jungle/small/style_2,
/turf/open/floor/grass,
/area/centcom/thanos_farm)
"y" = (
/obj/structure/flora/bush/fullgrass/style_3,
/turf/open/floor/grass,
/area/centcom/thanos_farm)
"C" = (
/obj/structure/flora/tree/jungle/style_3,
/turf/open/floor/grass,
/area/centcom/thanos_farm)
"D" = (
/obj/structure/flora/tree/jungle/style_2,
/turf/open/floor/grass,
/area/centcom/thanos_farm)
"F" = (
/turf/open/floor/wood,
/area/centcom/thanos_farm)
"H" = (
/obj/structure/flora/bush/fullgrass,
/turf/open/floor/grass,
/area/centcom/thanos_farm)
"I" = (
/obj/structure/flora/tree/jungle/small,
/turf/open/floor/grass,
/area/centcom/thanos_farm)
"M" = (
/obj/structure/flora/bush/fullgrass/style_2,
/turf/open/floor/grass,
/area/centcom/thanos_farm)
"N" = (
/obj/structure/flora/tree/jungle/small/style_3,
/turf/open/floor/grass,
/area/centcom/thanos_farm)
"O" = (
/obj/structure/flora/tree/jungle/small/style_5,
/turf/open/floor/grass,
/area/centcom/thanos_farm)
"R" = (
/obj/structure/flora/tree/jungle/small/style_4,
/turf/open/floor/grass,
/area/centcom/thanos_farm)
"X" = (
/obj/structure/flora/tree/jungle,
/turf/open/floor/grass,
/area/centcom/thanos_farm)
"Z" = (
/obj/structure/flora/tree/jungle/style_6,
/turf/open/floor/grass,
/area/centcom/thanos_farm)

(1,1,1) = {"
a
a
a
a
a
a
a
a
a
a
a
a
a
a
a
a
a
a
a
a
a
a
a
a
a
a
a
a
a
a
a
a
a
a
a
a
a
a
a
a
a
a
a
a
a
a
a
a
a
a
a
a
a
a
a
"}
(2,1,1) = {"
a
n
n
n
n
n
n
n
n
n
n
n
n
n
n
n
n
n
n
n
n
n
n
n
n
n
n
n
n
n
n
n
n
n
n
n
n
n
n
n
j
j
n
n
b
b
b
b
b
b
y
b
b
b
a
"}
(3,1,1) = {"
a
n
n
n
n
n
n
n
n
n
n
n
n
n
n
n
n
n
n
n
n
n
n
n
n
n
n
n
n
n
n
n
n
n
n
n
n
n
n
j
j
j
n
n
b
b
b
C
b
O
b
b
X
H
a
"}
(4,1,1) = {"
a
n
p
n
n
n
n
n
n
n
n
n
n
n
n
n
n
n
n
n
n
n
n
n
n
n
n
n
n
n
n
n
n
n
n
n
n
n
j
j
j
j
n
n
b
b
b
b
b
H
b
b
M
b
a
"}
(5,1,1) = {"
a
n
n
n
n
n
p
n
n
n
n
n
n
n
n
n
n
n
n
n
n
n
n
n
n
n
n
n
n
n
n
n
n
n
n
n
n
n
j
j
j
j
n
n
b
b
Z
b
x
b
b
I
b
y
a
"}
(6,1,1) = {"
a
n
n
n
n
n
n
n
n
n
n
n
n
n
n
n
n
n
n
n
n
n
n
n
n
n
n
n
n
n
n
n
n
n
n
n
n
j
j
j
j
n
n
n
b
b
b
b
b
b
b
b
H
b
a
"}
(7,1,1) = {"
a
n
n
n
n
n
n
n
n
n
n
n
n
n
n
n
n
n
n
n
n
n
n
n
n
n
n
n
n
n
n
n
n
n
n
n
n
j
j
j
n
n
n
n
b
d
d
d
d
d
d
d
b
b
a
"}
(8,1,1) = {"
a
n
n
n
p
n
n
n
n
n
n
n
n
n
n
n
n
n
n
n
n
n
n
n
n
n
n
n
n
n
n
n
n
n
n
n
j
j
j
n
n
n
n
n
b
d
e
g
i
m
k
d
b
y
a
"}
(9,1,1) = {"
a
n
n
n
n
n
n
n
n
n
n
n
n
n
n
n
n
n
n
n
n
n
n
n
n
n
n
n
n
n
n
n
n
n
n
n
j
j
j
n
n
n
n
n
b
d
f
g
g
q
m
d
b
b
a
"}
(10,1,1) = {"
a
n
n
n
n
n
n
n
n
n
n
n
n
n
n
n
n
n
n
n
n
n
n
n
n
n
n
n
n
n
n
n
n
n
n
n
j
j
j
n
n
n
n
n
b
d
t
g
g
g
k
d
b
u
a
"}
(11,1,1) = {"
a
n
n
n
n
n
n
n
n
n
n
n
n
n
n
n
n
n
n
n
n
n
n
n
n
n
n
n
n
n
n
n
n
n
n
j
j
j
n
n
n
n
n
n
b
d
g
q
g
g
l
d
b
b
a
"}
(12,1,1) = {"
a
b
b
b
b
o
b
b
b
b
b
b
b
b
b
b
b
b
b
b
b
b
b
b
b
b
b
b
b
b
b
b
b
b
F
F
F
F
b
b
b
b
b
b
c
d
g
g
g
g
k
d
y
b
a
"}
(13,1,1) = {"
a
o
b
b
b
b
b
b
b
b
b
b
b
b
b
b
b
b
b
b
b
b
b
b
b
b
b
b
b
b
b
b
b
F
F
F
F
b
b
b
b
b
b
b
b
b
g
g
g
q
k
d
b
M
a
"}
(14,1,1) = {"
a
b
b
b
b
b
b
b
b
b
b
b
b
b
b
b
b
b
b
b
b
b
b
b
b
b
b
b
b
b
b
b
F
F
F
F
b
b
b
b
b
b
b
b
c
d
g
g
g
g
m
d
b
b
a
"}
(15,1,1) = {"
a
n
n
n
n
n
n
n
n
n
n
n
n
n
n
n
n
n
n
n
n
n
n
n
n
n
n
n
n
n
n
n
j
j
j
n
n
n
n
n
n
n
n
n
b
d
g
q
g
g
k
d
N
b
a
"}
(16,1,1) = {"
a
n
n
n
n
n
n
n
n
n
n
n
n
n
n
n
n
n
n
n
n
n
n
n
n
n
n
n
n
n
n
j
j
j
j
n
n
n
n
n
n
n
n
n
b
d
s
g
g
g
m
d
b
y
a
"}
(17,1,1) = {"
a
n
n
p
n
n
n
n
n
n
n
n
n
n
n
n
n
n
n
n
n
n
n
n
n
n
n
n
n
n
n
j
j
j
n
n
n
n
n
n
n
n
n
n
b
d
r
g
g
q
k
d
M
b
a
"}
(18,1,1) = {"
a
n
n
n
n
n
n
n
n
n
n
n
n
n
n
n
n
n
n
n
n
n
n
n
n
n
n
n
n
n
n
j
j
j
n
n
n
n
n
n
n
n
n
n
b
d
h
g
k
k
k
d
b
b
a
"}
(19,1,1) = {"
a
n
n
n
n
n
n
n
n
n
n
n
n
n
n
n
n
n
n
n
n
n
n
n
n
n
n
n
n
n
n
j
j
j
n
n
n
n
n
n
n
n
n
n
b
d
d
d
d
d
d
d
y
b
a
"}
(20,1,1) = {"
a
n
p
n
n
n
n
p
n
n
n
n
n
n
n
n
n
n
n
n
n
n
n
n
n
n
n
n
n
n
n
j
j
j
n
n
n
n
n
n
n
n
n
n
b
b
b
b
b
b
M
b
b
b
a
"}
(21,1,1) = {"
a
n
n
n
n
n
n
n
n
n
n
n
n
n
n
n
n
n
n
n
n
n
n
n
n
n
n
n
n
n
n
j
j
j
n
n
n
n
n
n
n
n
n
n
b
b
b
b
b
D
b
b
b
M
a
"}
(22,1,1) = {"
a
n
n
n
n
n
n
n
n
n
n
n
n
n
n
n
n
n
n
n
n
n
n
n
n
n
n
n
n
n
n
j
j
j
n
n
n
n
n
n
n
n
n
n
b
b
b
b
b
y
b
b
R
b
a
"}
(23,1,1) = {"
a
n
n
n
n
n
n
n
n
n
n
n
n
n
n
n
n
n
n
n
n
n
n
n
n
n
n
n
n
n
n
j
j
j
j
n
n
n
n
n
n
n
n
n
b
b
b
x
y
b
b
b
b
b
a
"}
(24,1,1) = {"
a
n
n
n
n
n
n
n
n
n
n
n
n
n
n
n
n
n
n
n
n
n
n
n
n
n
n
n
n
n
n
n
j
j
j
n
n
n
n
n
n
n
n
n
b
b
b
b
M
b
y
b
b
b
a
"}
(25,1,1) = {"
a
a
a
a
a
a
a
a
a
a
a
a
a
a
a
a
a
a
a
a
a
a
a
a
a
a
a
a
a
a
a
a
a
a
a
a
a
a
a
a
a
a
a
a
a
a
a
a
a
a
a
a
a
a
a
"}
