"ab" = (/obj/effect/turf_decal/siding/wood{dir = 4},/obj/effect/decal/cleanable/dirt/dust,/turf/open/floor/wood/icemoon)
"ax" = (/obj/effect/turf_decal/siding/wood/corner{dir = 1},/turf/open/floor/wood/icemoon)
"aL" = (/obj/effect/turf_decal/weather/snow/corner{dir = 9})
"aM" = (/obj/effect/turf_decal/siding/wood{dir = 8},/turf/open/floor/stone/icemoon)
"bc" = (/obj/effect/decal/cleanable/dirt/dust,/obj/effect/decal/cleanable/dirt/dust,/turf/open/floor/stone/icemoon)
"bl" = (/obj/effect/turf_decal/siding/wood{dir = 1},/obj/structure/railing/wooden_fencing{dir = 1},/turf/open/floor/wood/icemoon)
"bs" = (/obj/effect/turf_decal/weather/snow/corner{dir = 1},/obj/structure/railing/wooden_fencing{dir = 1})
"bu" = (/obj/structure/railing/wooden_fencing{dir = 4},/obj/structure/railing/wooden_fencing{dir = 8},/turf/open/floor/wood/icemoon)
"bJ" = (/obj/structure/window/green_glass_pane,/obj/structure/curtain/bounty,/turf/open/misc/asteroid/snow/icemoon)
"bW" = (/obj/effect/decal/cleanable/dirt/dust,/obj/structure/wall_torch/spawns_lit/directional/north,/turf/open/floor/wood/icemoon)
"cp" = (/obj/structure/railing/wooden_fencing/gate{dir = 1},/turf/open/misc/asteroid/snow/icemoon)
"cq" = (/obj/structure/railing/wooden_fencing{dir = 8},/turf/open/misc/asteroid/snow/icemoon)
"cA" = (/obj/structure/flora/ash/chilly,/turf/open/misc/asteroid/snow/icemoon)
"cB" = (/obj/effect/turf_decal/siding/wood{dir = 6},/obj/structure/railing/wooden_fencing{dir = 4},/obj/structure/railing/wooden_fencing,/obj/effect/decal/cleanable/dirt,/turf/open/floor/wood/icemoon)
"cD" = (/obj/effect/turf_decal/siding/wood{dir = 8},/obj/effect/turf_decal/weather/snow/corner{dir = 8},/turf/open/floor/wood/icemoon)
"cI" = (/obj/effect/turf_decal/siding/wood{dir = 8},/obj/effect/turf_decal/siding/wood{dir = 4},/obj/effect/turf_decal/weather/snow/corner{dir = 8},/obj/effect/turf_decal/weather/snow/corner{dir = 4},/turf/open/floor/wood/icemoon)
"cZ" = (/obj/structure/closet/crate/wooden/storage_barrel,/obj/item/stack/medical/aloe{pixel_y = -2},/obj/item/stack/medical/aloe{pixel_y = 2; pixel_x = 2},/obj/item/stack/medical/gauze/improvised{pixel_y = 6},/obj/item/bedsheet/black{pixel_x = 5; pixel_y = -2},/obj/item/bedsheet/black{pixel_x = 5; pixel_y = 12},/turf/open/floor/stone/icemoon)
"df" = (/obj/effect/turf_decal/siding/wood{dir = 1},/obj/structure/wall_torch/spawns_lit/directional/east,/turf/open/floor/wood/icemoon)
"dh" = (/obj/effect/turf_decal/siding/wood{dir = 8},/obj/effect/decal/cleanable/dirt,/turf/open/floor/wood/icemoon)
"di" = (/obj/effect/turf_decal/weather/snow/corner{dir = 10},/turf/open/openspace/icemoon)
"dk" = (/obj/structure/railing/wooden_fencing{dir = 1},/turf/open/misc/asteroid/snow/icemoon)
"dH" = (/obj/effect/turf_decal/siding/wood{dir = 10},/turf/open/floor/stone/icemoon)
"dO" = (/obj/effect/decal/cleanable/blood,/turf/open/floor/stone/icemoon)
"dX" = (/obj/effect/turf_decal/siding/wood{dir = 9},/turf/open/floor/wood/icemoon)
"eA" = (/obj/structure/railing/wooden_fencing/gate)
"eO" = (/obj/structure/railing/wooden_fencing{dir = 1},/obj/effect/decal/cleanable/dirt)
"fr" = (/obj/structure/railing/wooden_fencing{dir = 8},/obj/structure/railing/wooden_fencing{dir = 4},/turf/open/floor/wood/icemoon)
"fx" = (/obj/effect/turf_decal/weather/snow/corner{dir = 4},/obj/effect/turf_decal/weather/snow/corner{dir = 8})
"fN" = (/obj/effect/turf_decal/weather/snow/corner{dir = 6},/obj/effect/turf_decal/weather/snow/corner{dir = 1})
"fV" = (/obj/effect/turf_decal/siding/wood{dir = 9},/obj/structure/railing/wooden_fencing{dir = 1},/obj/structure/railing/wooden_fencing{dir = 8},/turf/open/floor/wood/icemoon)
"gq" = (/obj/effect/turf_decal/weather/snow/corner{dir = 1},/turf/open/openspace/icemoon)
"gu" = (/obj/structure/railing/wooden_fencing{dir = 1},/obj/structure/flora/ash/chilly,/turf/open/misc/asteroid/snow/icemoon)
"gG" = (/obj/effect/turf_decal/weather/snow/corner{dir = 8},/turf/open/openspace/icemoon)
"gS" = (/obj/effect/decal/cleanable/dirt,/obj/structure/wall_torch/spawns_lit/directional/south)
"gW" = (/obj/effect/turf_decal/siding/wood{dir = 1},/turf/open/floor/stone/icemoon)
"im" = (/obj/effect/turf_decal/weather/snow/corner,/obj/effect/turf_decal/weather/snow/corner{dir = 1})
"is" = (/obj/structure/flora/bush/sparsegrass/style_random,/obj/structure/railing/wooden_fencing{dir = 1},/obj/structure/railing/wooden_fencing{dir = 4},/turf/open/misc/asteroid/snow/icemoon)
"iJ" = (/obj/effect/turf_decal/siding/wood{dir = 10},/turf/open/floor/wood/icemoon)
"iO" = (/obj/structure/railing/wooden_fencing{dir = 8},/turf/open/floor/wood/icemoon)
"iX" = (/obj/effect/turf_decal/weather/snow/corner,/obj/machinery/smartfridge/wooden/produce_bin,/turf/open/misc/asteroid/snow/icemoon)
"jt" = (/obj/structure/wall_torch/spawns_lit/directional/south,/turf/open/misc/asteroid/snow/icemoon)
"jT" = (/obj/structure/curtain/bounty,/obj/effect/decal/cleanable/dirt,/turf/open/floor/stone/icemoon)
"kd" = (/obj/structure/mirror/directional/east,/turf/open/openspace/icemoon)
"ki" = (/obj/structure/railing/wooden_fencing{dir = 1},/turf/open/openspace/icemoon)
"kO" = (/obj/structure/wall_torch/spawns_lit/directional/south,/obj/effect/turf_decal/weather/snow/corner{dir = 1},/obj/effect/decal/cleanable/dirt,/turf/open/floor/wood/icemoon)
"li" = (/obj/effect/turf_decal/siding/wood{dir = 8},/obj/effect/decal/cleanable/dirt/dust,/turf/open/floor/wood/icemoon)
"lu" = (/obj/structure/railing/wooden_fencing/gate{dir = 1})
"lv" = (/obj/structure/wall_torch/spawns_lit/directional/north)
"lL" = (/obj/structure/mineral_door/wood/large_gate{dir = 1},/obj/effect/turf_decal/weather/dirt{dir = 1},/turf/open/floor/wood/icemoon)
"lN" = (/obj/effect/turf_decal/weather/snow/corner{dir = 1})
"mg" = (/obj/effect/decal/cleanable/dirt/dust,/obj/structure/wall_torch/spawns_lit/directional/south)
"mm" = (/obj/effect/turf_decal/weather/snow/corner{dir = 1},/obj/effect/turf_decal/weather/snow/corner)
"mH" = (/obj/structure/mineral_door/wood/large_gate{dir = 8},/turf/open/floor/wood/icemoon)
"mM" = (/obj/effect/turf_decal/siding/wood{dir = 6},/obj/effect/decal/cleanable/dirt,/obj/effect/decal/cleanable/dirt/dust,/turf/open/floor/wood/icemoon)
"mO" = (/obj/structure/wall_torch/spawns_lit/directional/south,/turf/open/floor/stone/icemoon)
"mZ" = (/obj/structure/curtain/bounty,/obj/effect/decal/cleanable/dirt/dust,/turf/open/floor/stone/icemoon)
"na" = (/obj/structure/flora/tree/pine/style_random,/obj/structure/railing/wooden_fencing{dir = 4},/turf/open/misc/asteroid/snow/icemoon)
"nd" = (/turf/open/misc/asteroid/snow/icemoon)
"nu" = (/obj/effect/turf_decal/weather/snow/corner{dir = 10},/obj/effect/turf_decal/weather/snow/corner{dir = 1})
"nz" = (/obj/structure/rack/wooden,/obj/item/reagent_containers/cup/bucket/wooden,/obj/item/reagent_containers/cup/bucket/wooden{pixel_y = -3; pixel_x = 8},/obj/structure/wall_torch/spawns_lit/directional/east,/turf/open/misc/asteroid/snow/icemoon)
"nV" = (/obj/effect/turf_decal/weather/snow/corner{dir = 8},/turf/open/floor/wood/icemoon)
"os" = (/obj/structure/flora/bush/sparsegrass/style_random,/turf/open/misc/asteroid/snow/icemoon)
"ox" = (/obj/effect/turf_decal/weather/snow/corner{dir = 9},/turf/open/openspace/icemoon)
"pa" = (/obj/structure/wall_torch/spawns_lit/directional/north,/obj/item/pillow/random{pixel_y = 4},/obj/effect/decal/cleanable/dirt/dust,/turf/open/floor/stone/icemoon)
"pk" = (/obj/structure/table/wood,/obj/item/food/grown/poppy/lily,/turf/open/floor/stone/icemoon)
"pl" = (/obj/effect/turf_decal/siding/wood{dir = 1},/obj/effect/decal/cleanable/dirt/dust,/obj/structure/wall_torch/spawns_lit/directional/west,/turf/open/floor/wood/icemoon)
"pq" = (/obj/effect/turf_decal/siding/wood{dir = 8},/obj/effect/decal/cleanable/dirt,/obj/structure/wall_torch/spawns_lit/directional/north,/turf/open/floor/stone/icemoon)
"pQ" = (/obj/effect/turf_decal/weather/snow/corner{dir = 6})
"pU" = (/obj/structure/wall_torch/spawns_lit/directional/south,/obj/effect/decal/cleanable/dirt/dust,/turf/open/floor/stone/icemoon)
"pX" = (/obj/effect/turf_decal/weather/snow/corner{dir = 8},/obj/effect/turf_decal/weather/snow/corner,/turf/open/openspace/icemoon)
"qj" = (/obj/effect/turf_decal/siding/wood{dir = 8},/obj/structure/railing/wooden_fencing{dir = 8},/obj/effect/decal/cleanable/dirt,/turf/open/floor/wood/icemoon)
"qn" = (/obj/structure/wall_torch/spawns_lit/directional/east,/turf/open/floor/wood/icemoon)
"qQ" = (/turf/closed/wall/mineral/stone)
"qR" = (/obj/structure/wall_torch/spawns_lit/directional/north,/obj/effect/decal/cleanable/dirt/dust)
"qU" = (/obj/effect/turf_decal/weather/snow/corner{dir = 1},/obj/effect/turf_decal/weather/snow/corner{dir = 4},/turf/open/openspace/icemoon)
"ry" = (/obj/effect/turf_decal/siding/wood/corner{dir = 8},/turf/open/floor/wood/icemoon)
"rA" = (/obj/structure/rack/wooden,/obj/item/food/grown/poppy/geranium,/turf/open/floor/wood/icemoon)
"rC" = (/obj/structure/railing/wooden_fencing{dir = 8},/turf/open/openspace/icemoon)
"rT" = (/obj/effect/turf_decal/siding/wood{dir = 8},/obj/structure/railing/wooden_fencing{dir = 8},/obj/effect/turf_decal/weather/snow/corner{dir = 8},/turf/open/floor/wood/icemoon)
"sO" = (/obj/structure/railing/wooden_fencing,/turf/open/misc/asteroid/snow/icemoon)
"ta" = (/obj/effect/turf_decal/weather/snow/corner,/turf/open/misc/asteroid/snow/icemoon)
"tx" = (/obj/structure/mineral_door/wood/large_gate{dir = 1},/obj/effect/turf_decal/siding/wood/corner,/turf/open/floor/wood/icemoon)
"tB" = (/obj/structure/curtain/bounty,/obj/effect/decal/cleanable/dirt/dust,/obj/structure/wall_torch/spawns_lit/directional/north,/turf/open/floor/stone/icemoon)
"ua" = (/obj/structure/railing/wooden_fencing{dir = 1},/obj/structure/railing/wooden_fencing{dir = 4},/turf/open/misc/asteroid/snow/icemoon)
"ue" = (/obj/structure/railing/wooden_fencing,/obj/structure/railing/wooden_fencing{dir = 4},/turf/open/misc/asteroid/snow/icemoon)
"uj" = (/obj/structure/table/wood,/obj/structure/large_mortar,/obj/item/pestle{pixel_y = -1; pixel_x = -8},/obj/effect/decal/cleanable/dirt/dust)
"ur" = (/obj/effect/turf_decal/siding/wood/corner{dir = 8},/obj/structure/mineral_door/wood/large_gate,/turf/open/floor/wood/icemoon)
"uC" = (/obj/structure/mineral_door/wood/large_gate{dir = 8},/obj/effect/decal/cleanable/dirt/dust,/turf/open/floor/wood/icemoon)
"uO" = (/obj/structure/window/green_glass_pane,/obj/structure/curtain/bounty,/turf/open/floor/stone/icemoon)
"vH" = (/obj/effect/turf_decal/siding/wood{dir = 9},/obj/effect/decal/cleanable/dirt/dust,/turf/open/floor/stone/icemoon)
"vW" = (/obj/structure/railing/wooden_fencing)
"wl" = (/obj/effect/decal/cleanable/dirt,/turf/open/floor/stone/icemoon)
"wF" = (/obj/effect/turf_decal/siding/wood{dir = 10},/obj/structure/railing/wooden_fencing{dir = 8},/obj/structure/railing/wooden_fencing,/turf/open/floor/wood/icemoon)
"xA" = (/obj/effect/turf_decal/weather/snow/corner{dir = 8})
"xM" = (/obj/effect/turf_decal/weather/snow/corner{dir = 4},/obj/structure/railing/wooden_fencing{dir = 4})
"yn" = (/obj/structure/flora/bush/snow/style_random,/turf/open/misc/asteroid/snow/icemoon)
"yA" = (/obj/structure/mineral_door/wood/large_gate,/obj/effect/turf_decal/weather/dirt{dir = 1},/turf/open/floor/wood/icemoon)
"yE" = (/obj/structure/railing/wooden_fencing{dir = 8},/obj/structure/railing/wooden_fencing,/turf/open/misc/asteroid/snow/icemoon)
"yL" = (/obj/effect/turf_decal/siding/wood{dir = 1},/obj/effect/decal/cleanable/dirt/dust,/turf/open/floor/wood/icemoon)
"yT" = (/obj/structure/rack/wooden,/obj/item/reagent_containers/cup/glass/bottle/small{pixel_x = -8},/obj/item/reagent_containers/cup/glass/bottle/small{pixel_x = 1},/obj/item/reagent_containers/cup/glass/bottle/small{pixel_x = 7},/obj/effect/decal/cleanable/dirt/dust)
"zr" = (/turf/open/floor/stone/icemoon)
"zO" = (/obj/effect/turf_decal/siding/wood{dir = 6},/turf/open/floor/stone/icemoon)
"Ac" = (/obj/structure/wall_torch/spawns_lit/directional/south,/obj/effect/decal/cleanable/dirt,/turf/open/floor/stone/icemoon)
"Ak" = (/obj/item/pillow/random{pixel_y = 4},/turf/open/floor/stone/icemoon)
"Al" = (/obj/structure/rack/wooden,/obj/item/food/grown/tobacco{pixel_y = -4; pixel_x = -4},/obj/item/food/grown/tobacco{pixel_y = -4; pixel_x = 2},/obj/item/plate/oven_tray/material/fake_tin{pixel_y = 5},/obj/item/plate/oven_tray/material/fake_brass{pixel_y = 8; pixel_x = 1},/obj/effect/decal/cleanable/dirt/dust,/obj/structure/wall_torch/spawns_lit/directional/east,/turf/open/floor/wood/icemoon)
"AT" = (/obj/effect/turf_decal/siding/wood{dir = 1},/obj/structure/railing/wooden_fencing{dir = 1},/obj/structure/chair/wood,/turf/open/floor/wood/icemoon)
"AV" = (/obj/effect/turf_decal/weather/snow/corner{dir = 4},/obj/effect/turf_decal/weather/snow/corner{dir = 8},/obj/effect/decal/cleanable/dirt,/turf/open/floor/wood/icemoon)
"Bf" = (/obj/structure/railing/wooden_fencing,/obj/effect/decal/cleanable/dirt)
"Bi" = (/obj/structure/flora/ash/chilly,/obj/structure/railing/wooden_fencing{dir = 4},/turf/open/misc/asteroid/snow/icemoon)
"Bs" = (/obj/effect/decal/cleanable/dirt)
"Bt" = (/turf/open/floor/wood/icemoon)
"BE" = (/obj/effect/turf_decal/weather/snow/corner{dir = 8},/obj/effect/turf_decal/weather/snow/corner{dir = 4})
"BR" = (/obj/effect/turf_decal/siding/wood{dir = 1},/turf/open/floor/wood/icemoon)
"BW" = (/obj/structure/dresser,/obj/structure/mirror/directional/south,/turf/open/floor/stone/icemoon)
"Cn" = (/obj/effect/decal/cleanable/dirt/dust,/turf/open/floor/stone/icemoon)
"Cp" = (/obj/structure/railing/wooden_fencing{dir = 1},/obj/effect/decal/cleanable/dirt/dust)
"Dc" = (/obj/effect/turf_decal/weather/snow/corner{dir = 1},/obj/effect/decal/cleanable/dirt)
"Dl" = (/obj/structure/wall_torch/spawns_lit/directional/south,/turf/open/openspace/icemoon)
"Dm" = (/obj/effect/turf_decal/siding/wood,/turf/open/floor/stone/icemoon)
"Ei" = (/obj/effect/turf_decal/weather/snow/corner{dir = 8},/obj/structure/railing/wooden_fencing{dir = 8},/turf/open/openspace/icemoon)
"Ej" = (/obj/structure/curtain/bounty,/obj/effect/decal/cleanable/blood,/obj/effect/decal/cleanable/dirt/dust,/turf/open/floor/stone/icemoon)
"Ez" = (/turf/open/openspace/icemoon)
"EB" = (/obj/effect/turf_decal/weather/snow/corner{dir = 9},/obj/structure/railing/wooden_fencing{dir = 1},/turf/open/openspace/icemoon)
"Fc" = (/obj/structure/railing/wooden_fencing{dir = 1},/obj/structure/flora/bush/snow/style_random,/turf/open/misc/asteroid/snow/icemoon)
"FJ" = (/obj/effect/turf_decal/siding/wood{dir = 5},/obj/structure/railing/wooden_fencing{dir = 1},/obj/structure/railing/wooden_fencing{dir = 4},/obj/structure/chair/wood{dir = 8},/turf/open/floor/wood/icemoon)
"FV" = (/obj/effect/turf_decal/weather/snow/corner{dir = 1},/obj/structure/railing/wooden_fencing{dir = 1},/turf/open/openspace/icemoon)
"Gn" = (/obj/structure/railing/wooden_fencing{dir = 4},/turf/open/misc/asteroid/snow/icemoon)
"Gp" = (/obj/effect/turf_decal/siding/wood,/obj/effect/decal/cleanable/dirt/dust,/turf/open/floor/wood/icemoon)
"Gr" = (/obj/effect/turf_decal/siding/wood{dir = 9},/obj/structure/railing/wooden_fencing{dir = 1},/obj/structure/railing/wooden_fencing{dir = 8},/obj/effect/decal/cleanable/dirt,/turf/open/floor/wood/icemoon)
"GH" = (/obj/structure/railing/wooden_fencing{dir = 8},/obj/structure/wall_torch/spawns_lit/directional/south,/turf/open/misc/asteroid/snow/icemoon)
"GO" = (/obj/structure/closet/crate/wooden/storage_barrel,/obj/item/reagent_containers/cup/glass/bottle/moonshine{pixel_x = -6},/obj/item/reagent_containers/cup/glass/bottle/moonshine{pixel_x = 8},/obj/item/reagent_containers/cup/glass/bottle/hooch{pixel_y = 8},/obj/effect/decal/cleanable/dirt/dust)
"Hg" = (/obj/effect/decal/cleanable/dirt/dust,/obj/effect/decal/cleanable/dirt,/turf/open/floor/wood/icemoon)
"Hi" = (/obj/effect/turf_decal/weather/snow/corner,/turf/open/openspace/icemoon)
"Hx" = (/obj/structure/flora/bush/sparsegrass/style_random,/obj/structure/railing/wooden_fencing{dir = 4},/turf/open/misc/asteroid/snow/icemoon)
"HF" = (/obj/structure/table/wood,/obj/item/reagent_containers/cup/primitive_centrifuge{pixel_x = -14; pixel_y = -1},/obj/item/paper_bin/bundlenatural{pixel_y = 8; pixel_x = 3},/obj/item/pen/charcoal,/obj/effect/decal/cleanable/dirt/dust)
"HW" = (/obj/effect/turf_decal/weather/snow/corner{dir = 1},/turf/open/floor/wood/icemoon)
"IC" = (/obj/effect/turf_decal/siding/wood/corner,/obj/effect/turf_decal/siding/wood/corner{dir = 4},/obj/effect/decal/cleanable/dirt,/turf/open/floor/wood/icemoon)
"Jw" = (/obj/structure/curtain/bounty,/obj/effect/decal/cleanable/dirt/dust,/turf/open/floor/wood/icemoon)
"Jz" = (/obj/effect/turf_decal/siding/wood,/obj/structure/railing/wooden_fencing,/obj/effect/decal/cleanable/dirt/dust,/turf/open/floor/wood/icemoon)
"JC" = (/obj/structure/mineral_door/wood/large_gate{dir = 1},/turf/open/floor/wood/icemoon)
"JT" = (/obj/structure/closet/crate/wooden/storage_barrel,/obj/item/instrument/guitar,/obj/item/instrument/glockenspiel,/turf/open/floor/stone/icemoon)
"Kc" = (/obj/effect/turf_decal/siding/wood{dir = 1},/obj/effect/decal/cleanable/dirt,/turf/open/floor/stone/icemoon)
"Kf" = (/obj/effect/turf_decal/siding/wood{dir = 5},/turf/open/floor/stone/icemoon)
"Kg" = (/obj/structure/wall_torch/spawns_lit/directional/west,/obj/effect/turf_decal/weather/snow/corner{dir = 4})
"Kh" = (/obj/structure/railing/wooden_fencing{dir = 8},/obj/effect/decal/cleanable/dirt,/turf/open/floor/wood/icemoon)
"Kq" = (/obj/structure/mineral_door/wood/large_gate,/turf/open/floor/wood/icemoon)
"La" = (/obj/structure/rack/wooden,/obj/item/retractor/ashwalker{pixel_y = -9},/obj/item/hemostat/ashwalker{pixel_y = 6},/obj/structure/wall_torch/spawns_lit/directional/north,/turf/open/floor/stone/icemoon)
"Lf" = (/obj/effect/turf_decal/weather/snow/corner)
"LK" = (/obj/structure/wall_torch/spawns_lit/directional/west,/obj/structure/flora/bush/snow/style_random,/turf/open/misc/asteroid/snow/icemoon)
"Mb" = (/obj/structure/rack/wooden,/obj/item/reagent_containers/cup/mortar{pixel_y = 9; pixel_x = 5},/obj/effect/decal/cleanable/dirt/dust)
"Mh" = (/obj/effect/turf_decal/weather/snow/corner{dir = 4},/turf/open/openspace/icemoon)
"Mn" = (/obj/structure/railing/wooden_fencing{dir = 1})
"MD" = (/obj/effect/turf_decal/weather/snow/corner{dir = 6},/obj/structure/railing/wooden_fencing,/obj/structure/railing/wooden_fencing{dir = 4})
"MK" = (/obj/structure/railing/wooden_fencing{dir = 8},/obj/structure/railing/wooden_fencing,/obj/structure/railing/wooden_fencing{dir = 1},/turf/open/misc/asteroid/snow/icemoon)
"Nu" = (/obj/effect/turf_decal/siding/wood{dir = 8},/turf/open/floor/wood/icemoon)
"NA" = ()
"NX" = (/obj/effect/turf_decal/weather/snow/corner{dir = 4})
"Ou" = (/obj/structure/curtain/bounty,/turf/open/floor/stone/icemoon)
"OG" = (/obj/effect/decal/cleanable/dirt/dust,/obj/structure/rack/wooden,/obj/item/food/grown/poppy/geranium/fraxinella,/turf/open/floor/stone/icemoon)
"Pe" = (/obj/structure/wall_torch/spawns_lit/directional/west,/turf/open/misc/asteroid/snow/icemoon)
"Pr" = (/obj/structure/rack/wooden,/obj/item/cautery/ashwalker{pixel_y = 10},/obj/item/scalpel/ashwalker{pixel_y = 6},/obj/item/circular_saw/ashwalker{pixel_y = -9},/obj/item/surgicaldrill/ashwalker{pixel_y = -7; pixel_x = 7},/turf/open/floor/stone/icemoon)
"PK" = (/obj/effect/turf_decal/siding/wood,/obj/structure/railing/wooden_fencing,/turf/open/floor/wood/icemoon)
"PN" = (/obj/structure/wall_torch/spawns_lit/directional/east,/obj/effect/turf_decal/siding/wood{dir = 4},/turf/open/floor/wood/icemoon)
"PY" = (/obj/effect/turf_decal/weather/snow/corner{dir = 10},/obj/structure/railing/wooden_fencing,/turf/open/openspace/icemoon)
"Qi" = (/obj/effect/turf_decal/siding/wood{dir = 10},/obj/structure/railing/wooden_fencing{dir = 8},/obj/structure/railing/wooden_fencing,/obj/effect/turf_decal/weather/snow/corner{dir = 8},/turf/open/floor/wood/icemoon)
"Rb" = (/obj/effect/turf_decal/siding/wood{dir = 4},/turf/open/floor/wood/icemoon)
"Ri" = (/obj/effect/turf_decal/weather/snow/corner{dir = 6},/turf/open/openspace/icemoon)
"Rj" = (/obj/effect/turf_decal/siding/wood,/obj/effect/decal/cleanable/dirt/dust,/turf/open/floor/stone/icemoon)
"Rk" = (/obj/effect/turf_decal/siding/wood{dir = 4},/obj/structure/railing/wooden_fencing{dir = 4},/turf/open/floor/wood/icemoon)
"Rq" = (/obj/effect/turf_decal/siding/wood{dir = 6},/turf/open/floor/wood/icemoon)
"RI" = (/obj/effect/turf_decal/siding/wood/corner,/obj/effect/decal/cleanable/dirt/dust,/turf/open/floor/wood/icemoon)
"RW" = (/obj/effect/turf_decal/weather/snow/corner,/obj/structure/railing/wooden_fencing)
"Sj" = (/obj/effect/turf_decal/siding/wood{dir = 5},/obj/structure/railing/wooden_fencing{dir = 1},/obj/structure/railing/wooden_fencing{dir = 4},/obj/structure/chair/wood,/turf/open/floor/wood/icemoon)
"Sl" = (/obj/structure/wall_torch/spawns_lit/directional/north,/turf/open/misc/asteroid/snow/icemoon)
"Sq" = (/obj/structure/flora/tree/pine/style_random,/turf/open/misc/asteroid/snow/icemoon)
"St" = (/obj/structure/railing/wooden_fencing{dir = 8},/obj/structure/railing/wooden_fencing{dir = 1},/turf/open/misc/asteroid/snow/icemoon)
"Su" = (/obj/effect/turf_decal/weather/snow/corner{dir = 5},/turf/open/openspace/icemoon)
"SA" = (/obj/effect/turf_decal/siding/wood{dir = 5},/obj/structure/railing/wooden_fencing{dir = 1},/obj/structure/railing/wooden_fencing{dir = 4},/obj/effect/decal/cleanable/dirt,/turf/open/floor/wood/icemoon)
"SU" = (/obj/structure/railing/wooden_fencing{dir = 4},/obj/structure/railing/wooden_fencing{dir = 1},/turf/open/misc/asteroid/snow/icemoon)
"Tg" = (/obj/effect/turf_decal/siding/wood{dir = 5},/obj/structure/railing/wooden_fencing{dir = 1},/obj/structure/railing/wooden_fencing{dir = 4},/turf/open/floor/wood/icemoon)
"Tn" = (/obj/machinery/cauldron,/obj/effect/decal/cleanable/dirt/dust,/turf/open/floor/wood/icemoon)
"Tu" = (/obj/structure/wall_torch/spawns_lit/directional/south,/obj/item/pillow/random{pixel_y = 4},/turf/open/floor/stone/icemoon)
"TM" = (/obj/effect/turf_decal/weather/snow/corner{dir = 5},/obj/effect/decal/cleanable/dirt,/obj/effect/decal/cleanable/dirt,/turf/open/floor/wood/icemoon)
"TP" = (/obj/effect/decal/cleanable/dirt/dust,/obj/structure/wall_torch/spawns_lit/directional/north,/turf/open/floor/stone/icemoon)
"Ua" = (/obj/item/pillow/random{pixel_y = 4},/obj/effect/decal/cleanable/dirt/dust,/turf/open/floor/stone/icemoon)
"Ub" = (/obj/effect/decal/cleanable/dirt/dust)
"Uo" = (/turf/closed/wall/mineral/wood/nonmetal)
"Ut" = (/obj/effect/decal/cleanable/dirt,/turf/open/floor/wood/icemoon)
"UD" = (/obj/effect/turf_decal/siding/wood{dir = 6},/obj/structure/railing/wooden_fencing{dir = 4},/obj/structure/railing/wooden_fencing,/turf/open/floor/wood/icemoon)
"Va" = (/obj/structure/wall_torch/spawns_lit/directional/north,/obj/effect/decal/cleanable/dirt,/turf/open/floor/stone/icemoon)
"Vj" = (/obj/effect/turf_decal/siding/wood,/turf/open/floor/wood/icemoon)
"Vv" = (/obj/structure/window/green_glass_pane,/obj/structure/curtain/bounty,/turf/open/floor/wood/icemoon)
"Vw" = (/obj/effect/turf_decal/weather/snow/corner{dir = 10})
"VY" = (/obj/effect/turf_decal/weather/snow/corner{dir = 5})
"Wc" = (/obj/structure/railing/wooden_fencing{dir = 4},/obj/structure/railing/wooden_fencing,/turf/open/misc/asteroid/snow/icemoon)
"Wz" = (/obj/effect/decal/cleanable/dirt,/obj/effect/turf_decal/siding/wood{dir = 8},/turf/open/floor/wood/icemoon)
"WB" = (/obj/effect/turf_decal/siding/wood/corner,/obj/structure/closet/crate/wooden/storage_barrel,/obj/item/reagent_containers/cup/glass/bottle/moonshine{pixel_x = -6},/obj/item/reagent_containers/cup/glass/bottle/moonshine{pixel_x = 8},/obj/item/reagent_containers/cup/glass/bottle/hooch{pixel_y = 8},/turf/open/floor/stone/icemoon)
"WI" = (/obj/effect/turf_decal/weather/snow/corner{dir = 6},/obj/structure/railing/wooden_fencing,/turf/open/openspace/icemoon)
"WO" = (/obj/effect/turf_decal/weather/snow/corner,/obj/structure/geyser,/turf/open/misc/asteroid/snow/icemoon)
"Xa" = (/obj/structure/table/wood,/obj/structure/chem_separator{pixel_y = 12},/obj/effect/decal/cleanable/dirt/dust)
"Xo" = (/obj/structure/railing/wooden_fencing{dir = 4},/obj/structure/railing/wooden_fencing{dir = 8},/obj/effect/decal/cleanable/dirt/dust,/turf/open/floor/wood/icemoon)
"Xu" = (/obj/structure/rack/wooden,/obj/item/hairbrush,/obj/structure/railing/wooden_fencing{dir = 4},/obj/structure/railing/wooden_fencing{dir = 8},/turf/open/floor/wood/icemoon)
"XA" = (/obj/structure/curtain/bounty,/turf/open/floor/wood/icemoon)
"XQ" = (/obj/structure/mineral_door/wood/large_gate{dir = 8},/obj/effect/turf_decal/weather/snow/corner{dir = 8})
"Yb" = (/obj/effect/turf_decal/weather/snow/corner{dir = 1},/obj/effect/turf_decal/weather/snow/corner,/obj/effect/decal/cleanable/dirt)
"Yh" = (/obj/effect/turf_decal/siding/wood{dir = 8},/obj/structure/railing/wooden_fencing{dir = 8},/turf/open/floor/wood/icemoon)
"Yn" = (/turf/template_noop,/area/template_noop)
"YD" = (/obj/item/food/grown/aloe{pixel_x = 5},/obj/item/food/grown/aloe,/obj/item/food/grown/aloe{pixel_y = 5},/obj/structure/closet/crate/wooden/storage_barrel,/obj/effect/decal/cleanable/dirt/dust,/obj/structure/wall_torch/spawns_lit/directional/west,/turf/open/floor/wood/icemoon)
"ZA" = (/obj/structure/mineral_door/wood/large_gate{dir = 8},/obj/effect/turf_decal/weather/snow/corner{dir = 4})
"ZR" = (/obj/effect/decal/cleanable/dirt/dust,/turf/open/floor/wood/icemoon)

(1,1,1) = {"
YnYnYnYnYnYnYnEzEzEzEzEzEzEzEzEzEzYnYnYnYnYnYnYnYnYnYnYnYnYnYnYnYnYnYnYnYnYnYnYnYnYnYnYnYnYn
YnYnYnEzEzEzEzEzEzEzqQVvVvqQqQEzEzEzYnEzEzEzEzEzEzEzEzEzEzEzEzEzEzEzEzEzEzEzEzEzEzEzEzEzYnYn
YnEzEzEzEzEzEzEzqQqQqQAkUarCqQqQEzHiHiHiEzEzEzEzEzEzEzEzEzEzEzEzEzEzEzEzEzEzEzEzEzEzEzEzEzYn
YnEzEzEzEzEzEzEzVvJTpazrzrrCEzUoWIStcpSUPYfVblFJEzEzfVblTgEzEzEzEzEzEzEzEzEzEzEzEzEzEzEzEzEz
YnEzEzEzEzEzNAEzVvAkzrwldXrCkdUondndndndndrTBtRkEzEzYhBtRkEzEzEzEzEzEzEzEzEzEzEzEzEzEzEzEzEz
YnEzEzEzEzEzNANAVvAkzrdXaxBtHgUondSqndcAndQiVjUDEzEzwFVjUDEzEzEzEzEzEzEzEzEzEzEzEzEzEzEzEzEz
YnEzEzEzNANANANAVvOGTuWzHgrAqQqQndndndndndEiEzEzEzEzEzEzEzEzEzEzEzEzEzEzEzEzEzEzEzEzEzEzEzEz
YnEzEzEzNANANANAqQqQqQqQKqqQqQynndosndndsOEiEzEzEzEzEzEzEzEzEzEzEzEzEzEzEzEzEzEzEzEzEzEzEzEz
YnEzEzEzNANANANANANAxMSlAVSlndndndndndnaoxEzEzEzEzEzEzEzEzEzEzEzEzEzEzEzEzEzEzEzEzEzEzEzEzEz
YnEzEzEzNANANANANANAMDndnVkOHWTMjtndndGndiHiHiHiHiHiHiHiEzEzEzEzEzEzEzEzEzEzEzEzEzEzEzEzEzEz
YnEzEzEzNANAEzEzEzRicqqQUoUourtxUoUoqQnddkdkdkdkdkdkdkdkdkFcSUHiHiHiHiHiEzEzEzEzEzEzEzEzEzEz
YnEzEzEzNANAEzEzMhStndUozrmZliRbmZzrUondcAndaLlNlNlNVYndndndnddkdkdkguuadiHiHiEzEzEzEzEzEzEz
YnEzEzEzNANAEzEzRicqnduOAcOudhRbOuzruOndndnuNANANANANAlNmmlNmmfNndndndnddkdkuadiEzEzEzEzEzEz
YnEzEzEzNANAEzMhMKsOndUoUoUoNuabOuAcUondndosVwLfLfLfLfpQndBEndndqQUouOuOUoqQnduagGEzEzEzEzEz
YnEzEzEzNANAEzEzgqSucquOzrOuNuPNUoUoUoLKndndndndndndndndndBEndndUotBPrEjLaUondGnEzEzEzEzEzEz
YnEzEzfVATTgEzEzEzRicqUopUjTliICBtUtmHDcYbmmmmmmmmmmmmmmmmNXndndVvdOzrzrCnVvndGngGEzEzEzEzEz
YnEzEzqjBtabEzEzMhStndUoUoUoNuPNUoUoUoKgtataiXtataWOtatataxAVYosUocZzrbcWBUondBigGEzEzEzEzEz
YnEzEzwFPKUDEzEzMhcqosuOVaOuiJmMOuwluONXndaLlNlNlNlNlNlNlNNANXndqQqQpldfqQqQndGndiEzEzEzEzEz
YnEzEzEzEzEzEzEzMhyEndUozrUoBWzrUomOUoNAmmNANANANANANALfLfLfNXndndbJZRBtbJndynndSUpXHiEzEzEz
YnEzEzEzEzEzEzEzEzSucqqQUoUoUoUoUoUoqQNXndxANANANANANXosndndfxnzqQqQXAJwqQqQPendnddkisgGEzEz
YnEzEzfVblSAEzEzEzMhyEsOsOndoscDRbRWLfpQndVwNANANANANXndndndVwimmHbWZRBtbWuCmmimimVYGngGEzEz
YnEzEzYhBtRbEzEzEzEzgqgqSuyEWcgGEzSuyEsOsOndxANANANANXndndndndqQqQYDBtZRAlqQqQndcAfxGngGEzEz
YnEzEzwFJzUDEzEzEzEzEzEzEzgqgqEzEzEzgqgqqUcqxANALfLfpQndndynndXQTnBtZRZRBtZRZAndndfxGngGEzEz
YnEzEzEzEzEzNAEzEzNANAEzEzNANAEzEzNANAEzNXGHxANXjtndndsOsOndosqQqQGpryRIVjqQqQndsOcIWcgGEzEz
YnEzEzEzNANANANANANANANANANANANANANANANANAUoyAlLUoyEueaLNXcqndndbJGOiJRqyTbJndGnoxEzgqEzEzEz
YnEzEzNANANAUoUoUobJbJUoUobJbJUoUobJbJUoUoUoZRBtUoNANANANXcqndcAbJXaujHFMbbJndGngGEzEzEzEzEz
YnEzEzEzNANAUoUblvNAfrBsqRNAXuUblvNAbuNAqRNAiOBtUoNANANANXyEndndbJbJbJbJbJbJndGngGEzEzEzEzEz
YnEzEzEzNANAbJvWeABffrvWeAvWXovWeABfbuBfeAvWKhBtUoNANANANAVYyEndndndndndndndndHxgGEzEzEzEzEz
YnEzEzNANANAbJBtBtBtBtBtBtBtBtBtBtBtBtBtBtBtBtZRUoNANANANANAVYcqosndndndndynGnEBEzEzEzEzEzEz
YnEzEzNANANAbJUtvHgWgWgWgWKcgWgWgWgWgWgWgWgWKfqnUoNANANANANANAbsFVFVFVFVFVFVFVEzEzEzEzEzEzEz
YnEzEzEzNANAbJBtdHDmDmDmDmDmDmDmDmDmDmRjDmDmzOBtUoNANANANANAEzEzEzEzEzEzEzEzEzEzEzEzEzEzEzEz
YnEzEzNANANAbJBtBtBtBtZRBtBtBtBtBtUtBtBtBtBtZRBtUoNANANANANAEzEzEzEzEzEzEzEzEzEzEzEzEzEzEzEz
YnEzEzEzNANAbJCpeOluMnMnMnCpUoKqJCUoUoUoUoUoUoUoUoNANANANANAGrBRTgEzEzfVyLSjEzEzEzEzEzEzEzEz
YnEzEzEzNANAUoNANANANAUbNANAUoUtBtBtpqzrAkpkAkTPUoNANANANAEzYhZRRkEzEzYhBtRkEzEzEzEzEzEzEzEz
YnEzEzEzEzNAUoUomgBsNANANAgSUoBtBtZRaMzrwlzrzrzrUoNANAEzEzEzwFPKUDEzEzwFPKcBEzEzEzEzEzEzEzEz
YnEzEzEzEzNANAUoUobJbJbJbJUoUoBtBtUtkikikikikikiUoNAEzEzEzEzEzEzEzEzEzEzEzEzEzEzEzEzEzEzEzEz
YnEzEzEzEzEzNANANANANANANANAUoUoUoZRDlEzEzEzEzDlUoNAEzEzEzEzEzEzEzEzEzEzEzEzEzEzEzEzEzEzEzEz
YnEzEzEzEzEzEzEzNAEzEzNAEzNANANAUoUoUoUoUoUoUoUoUoEzEzEzEzEzEzEzEzEzEzEzEzEzEzEzEzEzEzEzEzYn
YnYnEzEzEzEzEzEzEzEzEzEzEzEzEzEzEzEzEzEzEzEzEzEzEzEzEzEzEzEzEzEzEzEzEzEzEzEzEzEzEzEzEzEzEzYn
YnYnYnYnYnYnYnYnYnYnYnYnYnYnYnYnYnYnYnYnYnYnYnYnYnYnYnYnYnYnYnYnYnYnYnYnYnYnYnYnYnYnYnYnYnYn
"}
